[金符石]
一阶金符石=二阶金符石
二阶金符石=三阶金符石
三阶金符石=四阶金符石
四阶金符石=五阶金符石
五阶金符石=六阶金符石
六阶金符石=七阶金符石
七阶金符石=八阶金符石
八阶金符石=九阶金符石

[木符石]
一阶木符石=二阶木符石
二阶木符石=三阶木符石
三阶木符石=四阶木符石
四阶木符石=五阶木符石
五阶木符石=六阶木符石
六阶木符石=七阶木符石
七阶木符石=八阶木符石
八阶木符石=九阶木符石

[水符石]
一阶水符石=二阶水符石
二阶水符石=三阶水符石
三阶水符石=四阶水符石
四阶水符石=五阶水符石
五阶水符石=六阶水符石
六阶水符石=七阶水符石
七阶水符石=八阶水符石
八阶水符石=九阶水符石

[火符石]
一阶火符石=二阶火符石
二阶火符石=三阶火符石
三阶火符石=四阶火符石
四阶火符石=五阶火符石
五阶火符石=六阶火符石
六阶火符石=七阶火符石
七阶火符石=八阶火符石
八阶火符石=九阶火符石

[土符石]
一阶土符石=二阶土符石
二阶土符石=三阶土符石
三阶土符石=四阶土符石
四阶土符石=五阶土符石
五阶土符石=六阶土符石
六阶土符石=七阶土符石
七阶土符石=八阶土符石
八阶土符石=九阶土符石


